NO          ./textures/wall_e.xpm


R        480 240

SO  ./textures/wall_s.xpm
WE ./textures/wall_3.xpm

EA ./textures/wall_s.xpm



S ./textures/barrel.xpm
F 0,58,49
C 56,0,230



        11111111111111 1111111111
        1222222222121111222222221
        1011200001112000000000021
        1001200000000000000000021
111111111011200001100020000022221
100000000011220001100000000011111
11110111111111011100000000001
11110111111111011101010000001
11000000110101011100000N00001
10002000000000001100000000001
10000000000000001101010000001
1100000111010101111101100000111
11110111 1110101 101111010001
11111111 1111111 111111111111
